01113111111111311111110
10000000000001000000001
10003111311001000010004
10000000001000000330002
10001300001003300000004
30000000000000000010001
10000000001110000000001
10000000000000000002001
30000000000000300002001
10003333330000002222001
10000000000000000000001
01111311113111111331110